; 1

####
# .#
#  ###
#*@  #
#  $ #
#  ###
####

; 2

######
#    #
# #@ #
# $* #
# .* #
#    #
######
